
kopi-c-ga-dai.wav	kopi c ga dai
kopi-c-peng.wav	kopi c peng
kopi-c-siew-dai.wav	kopi c siew dai
kopi-c.wav	kopi c
kopi-ga-dai.wav	kopi ga dai
kopi-gao.wav	kopi gao
kopi-kosong.wav	kopi kosong
kopi-o-ga-dai.wav	kopi o ga dai
kopi-o-gao.wav	kopi o gao
kopi-o-kosong.wav	kopi o kosong
kopi-o-siew-dai.wav	kopi o siew dai
kopi-o.wav	kopi o
kopi-siew-dai.wav	kopi siew dai
kopi.wav	kopi
teh-c-ga-dai.wav	teh c ga dai
teh-c-peng.wav	teh c peng
teh-c-siew-dai.wav	teh c siew dai
teh-c.wav	teh c
teh-ga-dai.wav	teh ga dai
teh-gao.wav	teh gao
teh-kosong.wav	teh kosong
teh-o-ga-dai.wav	kopi o ga dai
teh-o-gao.wav	teh o gao
teh-o-kosong.wav	teh o kosong
teh-o-siew-dai.wav	teh o siew dai
teh-o.wav	teh o
teh-siew-dai.wav	teh siew dai
teh.wav	teh
